Name	ElectionDistrict
CO State House District 1	Colorado;CO State House District 1
CO State House District 10	Colorado;CO State House District 10
CO State House District 11	Colorado;CO State House District 11
CO State House District 12	Colorado;CO State House District 12
CO State House District 13	Colorado;CO State House District 13
CO State House District 14	Colorado;CO State House District 14
CO State House District 15	Colorado;CO State House District 15
CO State House District 16	Colorado;CO State House District 16
CO State House District 17	Colorado;CO State House District 17
CO State House District 18	Colorado;CO State House District 18
CO State House District 19	Colorado;CO State House District 19
CO State House District 2	Colorado;CO State House District 2
CO State House District 20	Colorado;CO State House District 20
CO State House District 21	Colorado;CO State House District 21
CO State House District 22	Colorado;CO State House District 22
CO State House District 23	Colorado;CO State House District 23
CO State House District 24	Colorado;CO State House District 24
CO State House District 25	Colorado;CO State House District 25
CO State House District 26	Colorado;CO State House District 26
CO State House District 27	Colorado;CO State House District 27
CO State House District 28	Colorado;CO State House District 28
CO State House District 29	Colorado;CO State House District 29
CO State House District 3	Colorado;CO State House District 3
CO State House District 30	Colorado;CO State House District 30
CO State House District 31	Colorado;CO State House District 31
CO State House District 32	Colorado;CO State House District 32
CO State House District 33	Colorado;CO State House District 33
CO State House District 34	Colorado;CO State House District 34
CO State House District 35	Colorado;CO State House District 35
CO State House District 36	Colorado;CO State House District 36
CO State House District 37	Colorado;CO State House District 37
CO State House District 38	Colorado;CO State House District 38
CO State House District 39	Colorado;CO State House District 39
CO State House District 4	Colorado;CO State House District 4
CO State House District 40	Colorado;CO State House District 40
CO State House District 41	Colorado;CO State House District 41
CO State House District 42	Colorado;CO State House District 42
CO State House District 43	Colorado;CO State House District 43
CO State House District 44	Colorado;CO State House District 44
CO State House District 45	Colorado;CO State House District 45
CO State House District 46	Colorado;CO State House District 46
CO State House District 47	Colorado;CO State House District 47
CO State House District 48	Colorado;CO State House District 48
CO State House District 49	Colorado;CO State House District 49
CO State House District 5	Colorado;CO State House District 5
CO State House District 50	Colorado;CO State House District 50
CO State House District 51	Colorado;CO State House District 51
CO State House District 52	Colorado;CO State House District 52
CO State House District 53	Colorado;CO State House District 53
CO State House District 54	Colorado;CO State House District 54
CO State House District 55	Colorado;CO State House District 55
CO State House District 56	Colorado;CO State House District 56
CO State House District 57	Colorado;CO State House District 57
CO State House District 58	Colorado;CO State House District 58
CO State House District 59	Colorado;CO State House District 59
CO State House District 6	Colorado;CO State House District 6
CO State House District 60	Colorado;CO State House District 60
CO State House District 61	Colorado;CO State House District 61
CO State House District 62	Colorado;CO State House District 62
CO State House District 63	Colorado;CO State House District 63
CO State House District 64	Colorado;CO State House District 64
CO State House District 65	Colorado;CO State House District 65
CO State House District 7	Colorado;CO State House District 7
CO State House District 8	Colorado;CO State House District 8
CO State House District 9	Colorado;CO State House District 9
CO State Senate District 1	Colorado;CO State Senate District 1
CO State Senate District 11	Colorado;CO State Senate District 11
CO State Senate District 13	Colorado;CO State Senate District 13
CO State Senate District 15	Colorado;CO State Senate District 15
CO State Senate District 16	Colorado;CO State Senate District 16
CO State Senate District 2	Colorado;CO State Senate District 2
CO State Senate District 20	Colorado;CO State Senate District 20
CO State Senate District 22	Colorado;CO State Senate District 22
CO State Senate District 24	Colorado;CO State Senate District 24
CO State Senate District 3	Colorado;CO State Senate District 3
CO State Senate District 30	Colorado;CO State Senate District 30
CO State Senate District 32	Colorado;CO State Senate District 32
CO State Senate District 34	Colorado;CO State Senate District 34
CO State Senate District 5	Colorado;CO State Senate District 5
CO State Senate District 6	Colorado;CO State Senate District 6
CO State Senate District 7	Colorado;CO State Senate District 7
CO State Senate District 9	Colorado;CO State Senate District 9
US House CO District 1	Colorado;US House CO District 1
US House CO District 2	Colorado;US House CO District 2
US House CO District 3	Colorado;US House CO District 3
US House CO District 4	Colorado;US House CO District 4
US House CO District 5	Colorado;US House CO District 5
US House CO District 6	Colorado;US House CO District 6
US House CO District 7	Colorado;US House CO District 7
US Senate CO	Colorado
CO Treasurer	Colorado
CO Secretary of State	Colorado
CO Attorney General	Colorado
CO Governor	Colorado