BallotName	Party
Karen McCormick	Colorado Democratic Party
Ken Buck	Colorado Republican Party
Richard Lyons Weil	Colorado Democratic Party
John B. Vigil	Colorado Green Party
Jared Polis / Dianne Primavera	Colorado Democratic Party
Walker Stapleton / Lang Sias	Colorado Republican Party
Bill Hammons / Eric Bodenstab	Colorado Unity Party of Colorado
Scott Helker / Michele Poague	Colorado Libertarian Party
Wayne Williams	Colorado Republican Party
Jena Griswold	Colorado Democratic Party
Amanda Campbell	Colorado American Constitution Party
Blake Huber	Colorado Approval Voting Party
Brian Watson	Colorado Republican Party
Dave Young	Colorado Democratic Party
Gerald F. Kilpatrick	Colorado American Constitution Party
Phil Weiser	Colorado Democratic Party
George Brauchler	Colorado Republican Party
William F. Robinson III	Colorado Libertarian Party
Tim Krug	Colorado Democratic Party
Debora L. Scheffel	Colorado Republican Party
Lesley Smith	Colorado Democratic Party
Ken Montera	Colorado Republican Party
Christopher E. Otwell	Colorado Unity Party of Colorado
James K. Treibert	Colorado Libertarian Party
Dafna Michaelson Jenet	Colorado Democratic Party
Susan Kochevar	Colorado Republican Party
Richard L. Gabriel	Colorado No party
John Daniel Dailey	Colorado No party
Rebecca Rankin Freyre	Colorado No party
Elizabeth L. Harris	Colorado No party
David J. Richman	Colorado No party
Jaclyn Brown	Colorado No party
Sharon D. Holbrook	Colorado No party
Edward Moss	Colorado No party
Donald S. Quick	Colorado No party
Brian Nathaniel Bowen	Colorado No party
Michael A. Cox	Colorado No party
Cindy Dang	Colorado No party
Byron Lynn Howell	Colorado No party
Sabino E. Romano	Colorado No party
Dianna L. Roybal	Colorado No party
Rod Bockenfeld	Colorado Republican Party
Dave Rose	Colorado Democratic Party
Kevin Gulbranson	Colorado Libertarian Party
Chris Martinez	Colorado No party
Shontel Marie Lewis	Colorado No party
JoyAnn Keener Ruscha	Colorado No party
Mike Coffman	Colorado Republican Party
Jason Crow	Colorado Democratic Party
Kat Martin	Colorado Libertarian Party
Dan Chapin	Colorado Unaffiliated
Christopher Allen	Colorado Green Party
Beth Martinez Humenik	Colorado Republican Party
Faith Winter	Colorado Democratic Party
Donald Osborn	Colorado Libertarian Party
Adam Matkowsky	Colorado Unaffiliated
Rico Figueroa	Colorado Republican Party
Yadira Caraveo	Colorado Democratic Party
Bree Owens	Colorado Libertarian Party
Troy L. Whitmore	Colorado No party
Paul D. Solano	Colorado No party
Gerald Stephen Jaramillo	Colorado No party
Alexander "Skinny" Winkler	Colorado Republican Party
Kyle Mullica	Colorado Democratic Party
Ed Perlmutter	Colorado Democratic Party
Mark Barrington	Colorado Republican Party
Jennifer Nackerud	Colorado Libertarian Party
Steve Zorn	Colorado Democratic Party
Michael Haughey	Colorado Green Party
Phil Munsterman	Colorado No party
Bob Wilson	Colorado No party
Shelley Cook	Colorado No party
Adrienne Benavidez	Colorado Democratic Party
Vince Buzek	Colorado No party
Shannon Bird	Colorado Democratic Party
Bruce Baker	Colorado Republican Party
Ken Biles	Colorado Libertarian Party
Scott R. Tipton	Colorado Republican Party
Diane Mitsch Bush	Colorado Democratic Party
Gaylon Kent	Colorado Libertarian Party
Mary M. Malarsie	Colorado Independent
Richard Tetu	Colorado Unaffiliated
Bruce Lohmiller	Colorado Green Party
Gary Swing	Colorado Green Party
Alvin Rivera	Colorado Democratic Party
Glen H. Gallegos	Colorado Republican Party
Michael Stapleton	Colorado Libertarian Party
Donald E. Valdez	Colorado Democratic Party
Scott Honeycutt	Colorado Republican Party
Pattie P. Swift	Colorado No party
Daniel A. Walzl	Colorado No party
Charles Casper Stockham	Colorado Republican Party
Diana DeGette	Colorado Democratic Party
Raymon Anthony Doane	Colorado Libertarian Party
Miguel Lopez	Colorado Democratic Party
Toren Mushovic	Colorado Republican Party
Jeff Bridges	Colorado Democratic Party
Phillip L. Douglass	Colorado No party
Patricia Herron	Colorado No party
Gary M. Kramer	Colorado No party
Ben L. Leutwyler III	Colorado No party
Robert R. Lung	Colorado No party
Bonnie Heather McLean	Colorado No party
Peter F. Michaelson	Colorado No party
Michael Spear	Colorado No party
Shay K. Whitaker	Colorado No party
Colleen Clark	Colorado No party
Kelly LaFave	Colorado No party
Michael J. Roche	Colorado No party
Cheryl Rowles-Stokes	Colorado No party
Chris Kolker	Colorado Democratic Party
Susan Beckman	Colorado Republican Party
Emily Sirota	Colorado Democratic Party
Bob Lane	Colorado Republican Party
Richard J. Bowman	Colorado Republican Party
Mike Weissman	Colorado Democratic Party
Janet Buckner	Colorado Democratic Party
Richard Allen Bassett	Colorado Republican Party
Lynn Myers	Colorado Republican Party
Jovan Melton	Colorado Democratic Party
Tom Sullivan	Colorado Democratic Party
Cole Wist	Colorado Republican Party
Mike Donald	Colorado Republican Party
Dominique Jackson	Colorado Democratic Party
Guinn Unger Jr.	Colorado Democratic Party
Don Coram	Colorado Republican Party
Barbara McLachlan	Colorado Democratic Party
Paul Jones	Colorado Independent
Justin P. Fay	Colorado No party
Kimmi Lewis	Colorado Republican Party
Teri Nilson Baird	Colorado Democratic Party
Michael Davidson	Colorado No party
Debra M. Gunkel	Colorado No party
Joe Neguse	Colorado Democratic Party
Peter Yu	Colorado Republican Party
Roger Barris	Colorado Libertarian Party
Nick Thomas	Colorado Independent
Kevin Alumbaugh	Colorado Green Party
Johnny Barrett	Colorado Republican Party
Angelika Schroeder	Colorado Democratic Party
Tammy Story	Colorado Democratic Party
Tim Neville	Colorado Republican Party
James Gilman	Colorado Libertarian Party
Kevin Sipple	Colorado Republican Party
K.C. Becker	Colorado Democratic Party
Michael Dougherty	Colorado Democratic Party
Lynn Guissinger	Colorado No party
Thomas Francis Mulvahill	Colorado No party
Norma A. Sierra	Colorado No party
David Archuleta	Colorado No party
Elizabeth House Moulton Brodsky	Colorado No party
Eric Rutherford	Colorado Republican Party
Matt Gray	Colorado Democratic Party
Kim Tavendale	Colorado Libertarian Party
Jay Geyer	Colorado Independent
Sonya Jaquez Lewis	Colorado Democratic Party
Theresa Stets	Colorado Unaffiliated
Murl S. Hendrickson IV	Colorado Republican Party
Edie Hooton	Colorado Democratic Party
Jonathan Singer	Colorado Democratic Party
Brian O Donahue	Colorado Republican Party
Amy Elizabeth Bockman	Colorado No party
Stephany Rose Spaulding	Colorado Democratic Party
Doug Lamborn	Colorado Republican Party
Douglas Randall	Colorado Libertarian Party
Lori Furstenberg	Colorado Democratic Party
John Croom	Colorado Unaffiliated
Tony Wolusky	Colorado Democratic Party
Chance Hill	Colorado Republican Party
Kerry Donovan	Colorado Democratic Party
Olen Lund	Colorado Republican Party
Erin Kelley	Colorado Democratic Party
James D. "Jim" Wilson	Colorado Republican Party
Glenn Ingalls	Colorado Libertarian Party
Ramsey Lama	Colorado No party
Lynette Mary Wenner	Colorado No party
Jerry Sonnenberg	Colorado Republican Party
Debra Gustafson	Colorado Democratic Party
Rod Pelton	Colorado Republican Party
Bethleen McCall	Colorado Democratic Party
Gerald Keefe	Colorado No party
Beth "Hart" Harz	Colorado Democratic Party
Dennis Hisey	Colorado Republican Party
Kimberly Lynn Wood	Colorado No party
Amanda Jean Hunter	Colorado No party
Matt Soper	Colorado Republican Party
Thea Chase	Colorado Independent
Steven L. Schultz	Colorado No party
Keri A. Yoder	Colorado No party
Julie McCluskie	Colorado Democratic Party
Mike Mason	Colorado Republican Party
Susan Lontine	Colorado Democratic Party
Alysia Padilla	Colorado Republican Party
Darrell Dinges	Colorado Libertarian Party
Shelley I. Gilman	Colorado No party
David H. Goldberg	Colorado No party
Jay Sutherland Grant	Colorado No party
Morris B. Hoffman	Colorado No party
Kenneth Martin Laff	Colorado No party
Catherine A. Lemon	Colorado No party
Jennifer B. Torrington	Colorado No party
Johnny C. Barajas	Colorado No party
Brian Thomas Campbell	Colorado No party
Andrea Eddy	Colorado No party
Adam J. Espinosa	Colorado No party
Olympia Z. Fay	Colorado No party
Clarisse Gonzales	Colorado No party
Kerri Lombardi	Colorado No party
Chelsea Malone	Colorado No party
Alec Garnett	Colorado Democratic Party
Alex Valdez	Colorado Democratic Party
Katherine E. Whitney	Colorado Republican Party
Rory Lamberton	Colorado Libertarian Party
Chris Hansen	Colorado Democratic Party
Leslie Herod	Colorado Democratic Party
Robert Rodriguez	Colorado Democratic Party
Mark Calonder	Colorado Republican Party
Peter Lucas Smith	Colorado Independent
Angie Rivera-Malpiede	Colorado No party
Bonnie Ernest Archuleta	Colorado No party
Julia Stewart	Colorado No party
Eliot Tipton	Colorado No party
Jay Frank Kucera	Colorado Republican Party
James Rashad Coleman	Colorado Democratic Party
Julie Gonzales	Colorado Democratic Party
Gordon Alley	Colorado Republican Party
Robert "Dave" John	Colorado Republican Party
Serena Gonzales-Gutierrez	Colorado Democratic Party
Marc Catlin	Colorado Republican Party
Seth Cagin	Colorado Democratic Party
Todd Jay Plewe	Colorado No party
Mark Baisley	Colorado Republican Party
Kamala Vanderkolk	Colorado Democratic Party
Tony Gross	Colorado Libertarian Party
Lawrence Bowling	Colorado No party
Monica J. Gomez	Colorado No party
Susanna Meissner-Cutler	Colorado No party
Kim Ransom	Colorado Republican Party
Simone Aiken	Colorado Democratic Party
Danielle Kombo	Colorado Democratic Party
Patrick Neville	Colorado Republican Party
Julia Varnell-Sarjeant	Colorado Democratic Party
Chris Holbert	Colorado Republican Party
Steve Peterson	Colorado Independent
Kevin Van Winkle	Colorado Republican Party
Barrett Rothe	Colorado Democratic Party
Scott Wagner	Colorado Unity Party of Colorado
Nicki Mills	Colorado Republican Party
Dylan Roberts	Colorado Democratic Party
Luke Bray	Colorado Unaffiliated
Mary Elizabeth Fabian	Colorado Republican Party
Marc A. Snyder	Colorado Democratic Party
Maile Foster	Colorado Independent
Eric Bentley	Colorado No party
Linda Margaret Billings-Vela	Colorado No party
Jill M. Brady	Colorado No party
Robert L. Lowrey	Colorado No party
Timothy Schutz	Colorado No party
Larry Edward Schwartz	Colorado No party
Scott A. Sells	Colorado No party
David L. Shakes	Colorado No party
Christopher Edward Acker	Colorado No party
Lawrence D. Martin	Colorado No party
Douglas J. Miles	Colorado No party
Ann M. Rotolo	Colorado No party
Tim Geitner	Colorado Republican Party
Asia M. Zanders	Colorado Democratic Party
Terri Carver	Colorado Republican Party
Kent Edward Jarnig	Colorado Democratic Party
Lois Landgraf	Colorado Republican Party
Liz Rosenbaum	Colorado Democratic Party
Gil Armendariz	Colorado Democratic Party
Paul Lundeen	Colorado Republican Party
Shane Sandridge	Colorado Republican Party
Paul J. Haddick	Colorado Democratic Party
Brenda Krause	Colorado Democratic Party
Dave Williams	Colorado Republican Party
Andrew Smith	Colorado Democratic Party
Larry G. Liston	Colorado Republican Party
John Hjersman	Colorado Libertarian Party
Pete Lee	Colorado Democratic Party
Pat McIntire	Colorado Republican Party
Kit Roupe	Colorado Republican Party
Thomas "Tony" Exum Sr.	Colorado Democratic Party
Palmer L. Boyette	Colorado No party
Bri Buentello	Colorado Democratic Party
Don Bendell	Colorado Republican Party
Bob Rankin	Colorado Republican Party
Colin Wilhelm	Colorado Democratic Party
James Berkley Boyd	Colorado No party
Anne K. Norrdin	Colorado No party
Christopher G. Seldin	Colorado No party
Paul H. Metzger	Colorado No party
Jonathan Bruce Pototsky	Colorado No party
Christie A. Bachmeyer	Colorado No party
Diego G. Hunt	Colorado No party
Laura A. Tighe	Colorado No party
David C. Taylor	Colorado No party
Michael A. O'Hara III	Colorado No party
Nicholas Catanzarite	Colorado No party
Cindy Wilson	Colorado No party
Susan Lori Fisch	Colorado No party
Mark Marrow Randall	Colorado No party
Ryan James Stuart	Colorado No party
Thomas Vance	Colorado No party
Jean Woodford	Colorado No party
Todd Kastetter	Colorado Democratic Party
Colin Larson	Colorado Republican Party
Brad K. Evans	Colorado No party
Margaret (Peggy) A. Catlin	Colorado No party
Jennifer Hope	Colorado No party
Christine Jensen	Colorado Republican Party
Jessie Danielson	Colorado Democratic Party
Charles Messick	Colorado Libertarian Party
Brittany Pettersen	Colorado Democratic Party
Tony Sanchez	Colorado Republican Party
Steve Szutenbach	Colorado Republican Party
Lisa A. Cutter	Colorado Democratic Party
Arthur Erwin	Colorado Republican Party
Monica Duran	Colorado Democratic Party
Brianna Titone	Colorado Democratic Party
Vicki Pyne	Colorado Republican Party
Grady Nouis	Colorado Republican Party
Tracy Kraft-Tharp	Colorado Democratic Party
Hans V. Romer	Colorado Libertarian Party
Chris Kennedy	Colorado Democratic Party
Joan Poston	Colorado Republican Party
Kristina Joy Alley	Colorado Republican Party
Kerry Tipper	Colorado Democratic Party
Ross Klopf	Colorado Libertarian Party
Gary W. Davis	Colorado No party
Charles M. Hobbs	Colorado No party
Carl S. McGuire III	Colorado No party
Michael Keith Singer	Colorado No party
Michael K. Grinnan	Colorado No party
Donna Walter	Colorado Republican Party
Joann Ginal	Colorado Democratic Party
Thomas L. Lynch	Colorado No party
Peter E. Schoon Jr.	Colorado No party
Jeni Arndt	Colorado Democratic Party
Rebecca Cranston	Colorado Democratic Party
Rob Woodward	Colorado Republican Party
Perry L. Buck	Colorado Republican Party
Conor Duffy	Colorado Democratic Party
Joan Shaffer	Colorado Democratic Party
Hugh McKean	Colorado Republican Party
Truston Lee Fisher	Colorado No party
Ray Scott	Colorado Republican Party
Lance Phillip Timbreza	Colorado No party
Bruce R. Raaum	Colorado No party
Tanya Travis	Colorado Democratic Party
Janice Rich	Colorado Republican Party
Sandra H. Gardner	Colorado No party
JenniLynn Lawrence	Colorado No party
Ben A. Morris	Colorado No party
Douglas R. Manley	Colorado No party
Brian L. Green	Colorado No party
Erin Fernandez-Ely	Colorado No party
Curtis Lane Porter	Colorado No party
Leroy M. Garcia	Colorado Democratic Party
John Pickerill	Colorado Libertarian Party
Daneya Esgar	Colorado Democratic Party
Jonathan Ambler	Colorado Republican Party
Deborah R. Eyler	Colorado No party
Kim Karn	Colorado No party
Steven B. Fieldman	Colorado No party
David Lee Lobato	Colorado No party
Laurie Anne Noble	Colorado No party
Barbara A. Zollars	Colorado No party
James H. Garrecht	Colorado No party
Anna Ulrich	Colorado No party
Susanne J. Ross	Colorado No party
Theresa L. Kilgore	Colorado No party
Kelly S. Hansen	Colorado No party
Stephen Alan Humphrey	Colorado Republican Party
Gbenga Ajiboye	Colorado Democratic Party
James F. Hartmann	Colorado No party
Todd L. Taylor	Colorado No party
John Joseph Briggs	Colorado No party
Michele Lynn Meyer	Colorado No party
Dana Nichols	Colorado No party
Charles S. Unfug	Colorado No party
Lori A. Saine	Colorado Republican Party
Brandon D. Bobian	Colorado Democratic Party
Joe Johnson	Colorado Libertarian Party
John Cooke	Colorado Republican Party
Phil Kelley	Colorado Democratic Party
Eric E. Joss	Colorado Libertarian Party
Rochelle Galindo	Colorado Democratic Party
Michael A. Thuener	Colorado Republican Party
